xxxxxxxxxxxxxxxxxxxxxxxxx
x---------xx-------x----x
x---------x-x------x----x
x---c---c-x-----c-------x
xxxxx---xxxx---xxxxx----x
x---------x-------------x
x---------xxxx----------x
x-----------------------x
x-----x-------x----x----x
x-x-xxxxx-x----xxxxx----x
xx--------x-------------x
xxxxxxx---x-----xxxx----x
x-------x-x-x--xx--x----x
x--xxx----------xxxx----x
x-----------------------x
x-----------------------x
xxxxxxxxxxxxxxxxxxxxxxxxx

c objects/zap0.png
x objects/block2.png
- objects/ground0.png

