2
......................................
______________________________________
______________________________________
______________________________________
______________________________________
______________________________________
______________________________________
______________________________________
______________________________________
______________________________________
______________________________________
______________________________________
______________________________________
______________________________________
______________________________________
______________________________________

xxxxxxxxxxxxxxxxxxxxxxxxxxxxxxxxxxxxxx
x____________________________________x
x___xxxxxxxxxxxxxxx__________________x
x___xB____B____B__x__________________x
x___x_xxxxxxxxxx__x__________________x
x___xBx____x______x__________________x
x___x_x____x__BB__x__________________x
xxxxx_xxxx_x__BB__x__________________x
xP_AC__T_x_x_______x_________________x
x__z_____Raaxxxx_____________________x
x_~______baaaa_______________________x
x__F____cRaaaa_______________________x
xxxxxxxxxxxxxxxxxxxxxxxxxxxxxxxxxxxxxx

test_portal
fire
apple
stonewall
ground0
cherry
wood
portal_meadow
tree
stolb
wtf
rock
rocka
rock_portal
enemy_poringp
enemy_poringb
enemy_crab
endObjectNames

