2
..............................................
______________________________________________
______________________________________________
______________________________________________
______________________________________________
______________________________________________
______________________________________________
______________________________________________
____w_________________________________________
______________________________________________
______________________________________________
______________________________________________
______________________________________________
______________________________________________
______________________________________________
______________________________________________
______________________________________________
______________________________________________

xxxxxxxxxxxxxxxxxxxxxxxxxxxxxxxxxxxxxxxxxxxxxx
xD_cwrr___xx_______x____x____________________x
xW_A_bb___x_x______x___k_____________________x
xBSFAAAAc_x_____c______k_____________________x
xggWFCWFCxxx___xxxxx___k_____________________x
x_g____A__x_R===L_ss___k_____________________x
x______A__xx|x_E/_ssssskx____________________x
x_~___l__P__|__________kx____________________x
x_E===TTT===/_x____x___k_____________________x
x_x__x|||_x____xxxxx___k_____________________x
xx______l_x____________k_____________________x
xxxllllll_x_____xxxx_________________________x
x_______x_x_x__xx__x____x____________________x
x__xxx__________xxxx____x____________________x
x_______________________x____________________x
x_______________________x____________________x
xxxxxxxxxxxxxxxxxxxxxxxxxxxxxxxxxxxxxxxxxxxxxx

apple
stonewall
ground0
fish
cherry
wood
portal
tree
stolb
wtf
endObjectNames

